+------+------+------+
|  0      1      2   |
|                    |
+      +      +------+
|  1   |  2   |  5   |
|      |      |      |
+      +------+      +
|  2      3      4   |
|                    |
+------+------+------+