+---+---+---+
|           |
+   +   +---+
|   |   |   |
+   +---+   +
|           |
+---+---+---+