+------+------+------+
|                    |
|                    |
+      +      +------+
|      |      |      |
|      |      |      |
+      +------+      +
|                    |
|                    |
+------+------+------+