+---------+---------+---------+
|                             |
|                             |
|                             |
+         +         +---------+
|         |         |         |
|         |         |         |
|         |         |         |
+         +---------+         +
|                             |
|                             |
|                             |
+---------+---------+---------+