+------+------+------+
|  ∙------+------∙   |
|  |      |          |
+  |   +  |   +------+
|  |   |  ∙   |      |
|  |   |      |      |
+  |   +------+      +
|  ∙-------------∙   |
|                    |
+------+------+------+