+---+---+---+
| ∙---+---∙ |
+ | + | +---+
| | | ∙ |   |
+ | +---+   +
| ∙-------∙ |
+---+---+---+