+---------+---------+---------+
|                             |
|    ∙---------+---------∙    |
|    |         |              |
+    |    +    |    +---------+
|    |    |    |    |         |
|    |    |    ∙    |         |
|    |    |         |         |
+    |    +---------+         +
|    |                        |
|    ∙-------------------∙    |
|                             |
+---------+---------+---------+