  ______          ______  
 /      \        /      \ 
/   0    \______/   2    \
\                        /
 \______    1           / 
 /      \        /      \ 
/   6    \______/   3    \
\               \        /
 \          5    \      / 
 /      \               \ 
/   7    \______    4    \
\               \        /
 \______    8    \______/ 
        \        /        
         \______/         