   _________               _________   
  /         \             /         \  
 /           \           /           \ 
/      0      \_________/      2      \
\                                     /
 \                                   / 
  \_________       1                /  
  /         \             /         \  
 /           \           /           \ 
/      6      \_________/      3      \
\                       \             /
 \                       \           / 
  \                5      \         /  
  /         \                       \  
 /           \                       \ 
/      7      \_________       4      \
\                       \             /
 \                       \           / 
  \_________       8      \_________/  
            \             /            
             \           /             
              \_________/              