 ___     ___ 
/ 0 \___/ 2 \
\___  1     /
/ 6 \___/ 3 \
\     5 \   /
/ 7 \___  4 \
\___  8 \___/
    \___/    