   _________               _________   
  /         \             /         \  
 /           \           /           \ 
/             \_________/             \
\                                     /
 \                                   / 
  \_________                        /  
  /         \             /         \  
 /           \           /           \ 
/             \_________/             \
\                       \             /
 \                       \           / 
  \                       \         /  
  /         \                       \  
 /           \                       \ 
/             \_________              \
\                       \             /
 \                       \           / 
  \_________              \_________/  
            \             /            
             \           /             
              \_________/              