∙-----∙-----∙
 \         / 
  \       /  
   ∙     ∙   
  / \     \  
 /   \     \ 
∙     ∙     ∙
 \         / 
  \       /  
   ∙-----∙   