∙-------∙-------∙
 \             / 
  \           /  
   \         /   
    ∙       ∙    
   / \       \   
  /   \       \  
 /     \       \ 
∙       ∙       ∙
 \             / 
  \           /  
   \         /   
    ∙-------∙    