∙-----∙-----∙
 \    ∙--∙ / 
  \   |   /  
   ∙  |  ∙   
  /∙\ ∙--∙\  
 / | \   | \ 
∙  |  ∙  |  ∙
 \ ∙--∙--∙ / 
  \       /  
   ∙-----∙   