∙-------∙-------∙
 \             / 
  \     ∙---∙ /  
   \    |    /   
    ∙   |   ∙    
   / \  |    \   
  / ∙ \ ∙---∙ \  
 /  |  \    |  \ 
∙   |   ∙   |   ∙
 \  |       |  / 
  \ ∙---∙---∙ /  
   \         /   
    ∙-------∙    