   +------+            +------+   
  /        \          /        \  
 /          \        /          \ 
+            +------+            +
|     0         1   |     2      |
|                   |            |
+            +------+            +
 \                              / 
  \                            /  
   +------+            +      +   
   |  7   |     1      |  3   |   
   |      |            |      |   
   +      +            +      +   
  /        \          /        \  
 /          \        /          \ 
+            +------+            +
|     6         5         4      |
|                                |
+            +------+            +
 \          /        \          / 
  \        /          \        /  
   +------+            +------+   