    +---------+                 +---------+    
   /           \               /           \   
  /             \             /             \  
 /               \           /               \ 
+                 +---------+                 +
|                           |                 |
|                           |                 |
|                           |                 |
+                 +---------+                 +
 \                                           / 
  \                                         /  
   \                                       /   
    +---------+                 +         +    
    |         |                 |         |    
    |         |                 |         |    
    |         |                 |         |    
    +         +                 +         +    
   /           \               /           \   
  /             \             /             \  
 /               \           /               \ 
+                 +---------+                 +
|                                             |
|                                             |
|                                             |
+                 +---------+                 +
 \               /           \               / 
  \             /             \             /  
   \           /               \           /   
    +---------+                 +---------+    