  +---+       +---+  
 /     \     /     \ 
+       +---+       +
|           |       |
+       +---+       +
 \                 / 
  +---+       +   +  
  |   |       |   |  
  +   +       +   +  
 /     \     /     \ 
+       +---+       +
|                   |
+       +---+       +
 \     /     \     / 
  +---+       +---+  