  +---+       +---+  
 /     \     /     \ 
+       +---+       +
|   ∙       |   ∙   |
+    `. +---+ .´|   +
 \     ∙     ∙  |  / 
  +---+ `. .´ + | +  
  | ∙ |   ∙   | ∙ |  
  + | +       + | +  
 /  |  \     /  |  \ 
+   |   +---+   |   +
|   ∙-----∙-----∙   |
+       +---+       +
 \     /     \     / 
  +---+       +---+  