   +------+            +------+   
  /        \          /        \  
 /          \        /          \ 
+            +------+            +
|     ∙             |     ∙      |
|      `.           |   .´|      |
+        `.  +------+ .´  |      +
 \         ∙         ∙    |     / 
  \         `.     .´     |    /  
   +------+   `. .´    +  |   +   
   |  ∙   |     ∙      |  ∙   |   
   |  |   |            |  |   |   
   +  |   +            +  |   +   
  /   |    \          /   |    \  
 /    |     \        /    |     \ 
+     |      +------+     |      +
|     ∙---------∙---------∙      |
|                                |
+            +------+            +
 \          /        \          / 
  \        /          \        /  
   +------+            +------+   