    +---------+                 +---------+    
   /           \               /           \   
  /             \             /             \  
 /               \           /               \ 
+                 +---------+                 +
|                           |                 |
|        ∙                  |        ∙        |
|         `.                |      .´|        |
+           `.    +---------+    .´  |        +
 \            `.               .´    |       / 
  \             ∙             ∙      |      /  
   \             `.         .´       |     /   
    +---------+    `.     .´    +    |    +    
    |         |      `. .´      |    |    |    
    |    ∙    |        ∙        |    ∙    |    
    |    |    |                 |    |    |    
    +    |    +                 +    |    +    
   /     |     \               /     |     \   
  /      |      \             /      |      \  
 /       |       \           /       |       \ 
+        |        +---------+        |        +
|        |                           |        |
|        ∙-------------∙-------------∙        |
|                                             |
+                 +---------+                 +
 \               /           \               / 
  \             /             \             /  
   \           /               \           /   
    +---------+                 +---------+    